░░░░░░░░░░
░░░░░░░░░░
░░██████░░
░░█░░#░█░░
░░█+████░░
░░█░█░░░░░
░░█×█░░░░░
░░███░░░░░
░░░░░░░░░░
░░░░░░░░░░