░░██████░░
░█#░░░░░█░
█░░░░░░░░█
█░×░░░░×░█
█░░░░░░░░█
█░░░░░░░░█
█░█░░░░█░█
█░░████░░█
░█░░░░░░█░
+░██████░+