░░░░░░░░░░
░░░░████░░
░░███░░█░░
░░█#░×+██░
░░█░░░+░█░
░░█░█×░░█░
░░█░░░░░█░
░░███████░
░░░░░░░░░░
░░░░░░░░░░