░░░░░░░░░░
░░░░░░░░░░
░░██████░░
░░█#░░░██░
░░█░++░░█░
░░█░█×░×█░
░░█░░░░░█░
░░███████░
░░░░░░░░░░
░░░░░░░░░░