░░░░░░░░░░
░░░░░░░░░░
░░██████░░
░░█#░░░█░░
░░█░░+×█░░
░░█░×+░█░░
░░██████░░
░░░░░░░░░░
░░░░░░░░░░
░░░░░░░░░░