░░░░░░░░░░
░░░░░░░░░░
░░█████░░░
░░█#░░██░░
░░█×+*░█░░
░░█░░█░█░░
░░█░░░░█░░
░░██████░░
░░░░░░░░░░
░░░░░░░░░░